,first_name,last_name,GP,G,A,PTS,PIM
0,Leon,Draisaitl,71,43,67,110,18
1,Connor,McDavid,64,34,63,97,28
2,David,Pastrnak,70,48,47,95,40
3,Artemi,Panarin,69,32,63,95,20
4,Nathan,MacKinnon,69,35,58,93,12
5,Brad,Marchand,70,28,59,87,82
6,Nikita,Kucherov,68,33,52,85,38
7,Patrick,Kane,70,33,51,84,40
8,Auston,Matthews,70,47,33,80,8
9,Jack,Eichel,68,36,42,78,34
10,Jonathan,Huberdeau,69,23,55,78,30
11,Mika,Zibanejad,57,41,34,75,14
12,John,Carlson,69,15,60,75,26
13,Evgeni,Malkin,55,25,49,74,58
14,Kyle,Connor,71,38,35,73,34
15,Mark,Scheifele,71,29,44,73,45
16,J.T.,Miller,69,27,45,72,47
17,Alex,Ovechkin,68,48,19,67,30
18,Mitch,Marner,59,16,51,67,16
19,Sebastian,Aho,68,38,28,66,26
20,Max,Pacioretty,71,32,34,66,44
21,Steven,Stamkos,57,29,37,66,22
22,Elias,Pettersson,68,27,39,66,18
23,Blake,Wheeler,71,22,43,65,37
24,Roman,Josi,69,16,49,65,41
25,Brayden,Point,66,25,39,64,11
26,Patrik,Laine,68,28,35,63,22
27,Mark,Stone,65,21,42,63,27
28,Teuvo,Teravainen,68,15,48,63,8
29,Anze,Kopitar,70,21,41,62,16
30,Aleksander,Barkov,66,20,42,62,18
31,Travis,Konecny,66,24,37,61,28
32,Andrei,Svechnikov,68,24,37,61,54
33,Matthew,Tkachuk,69,23,38,61,74
34,Tomas,Tatar,68,22,39,61,36
35,Ryan,Nugent-Hopkins,65,22,39,61,33
36,Ryan,O'Reilly,71,12,49,61,10
37,John,Tavares,63,26,34,60,24
38,David,Perron,71,25,35,60,52
39,Mathew,Barzal,68,19,41,60,44
40,Jonathan,Toews,70,18,42,60,48
41,William,Nylander,68,31,28,59,12
42,Mike,Hoffman,69,29,30,59,28
43,Sean,Couturier,69,22,37,59,30
44,Ryan,Strome,70,18,41,59,48
45,Brayden,Schenn,71,25,33,58,44
46,Nikolaj,Ehlers,71,25,33,58,30
47,Johnny,Gaudreau,70,18,40,58,12
48,Jaden,Schwartz,71,22,35,57,18
49,Patrice,Bergeron,61,31,25,56,28
50,Bryan,Rust,55,27,29,56,30
51,Jakub,Voracek,69,12,44,56,31
52,Victor,Hedman,66,11,44,55,31
53,Elias,Lindholm,70,29,25,54,22
54,Reilly,Smith,71,27,27,54,20
55,Brock,Nelson,68,26,28,54,32
56,Kevin,Fiala,64,23,31,54,42
57,Nicklas,Backstrom,61,12,42,54,14
58,Bo,Horvat,69,22,31,53,21
59,Claude,Giroux,69,21,32,53,28
60,Dylan,Larkin,71,19,34,53,39
61,Tony,DeAngelo,68,15,38,53,47
62,Quinn,Hughes,68,8,45,53,22
63,Jakub,Vrana,69,25,27,52,18
64,Evgeny,Kuznetsov,63,19,33,52,40
65,Alex,Pietrangelo,70,16,36,52,20
66,Taylor,Hall,65,16,36,52,34
67,Sam,Reinhart,69,22,28,50,20
68,Tyler,Seguin,69,17,33,50,22
69,Cale,Makar,57,12,38,50,12
70,Alex,Killorn,68,26,23,49,20
71,T.J.,Oshie,69,26,23,49,26
72,Timo,Meier,70,22,27,49,42
73,Pierre-Luc,Dubois,70,18,31,49,49
74,Torey,Krug,61,9,40,49,33
75,Sean,Monahan,70,22,26,48,25
76,Filip,Forsberg,63,21,27,48,29
77,Tyler,Bertuzzi,71,21,27,48,40
78,Ryan,Suter,69,8,40,48,12
79,Evander,Kane,64,26,21,47,122
80,Evgenii,Dadonov,69,25,22,47,10
81,Jonathan,Marchessault,66,22,25,47,28
82,Eric,Staal,66,19,28,47,28
83,Sidney,Crosby,41,16,31,47,15
84,Phillip,Danault,71,13,34,47,32
85,Dominik,Kubalik,68,30,16,46,16
86,Zach,Parise,69,25,21,46,8
87,Pavel,Buchnevich,68,16,30,46,24
88,William,Karlsson,63,15,31,46,16
89,Shea,Theodore,71,13,33,46,25
90,Kyle,Palmieri,65,25,20,45,41
91,Chris,Kreider,63,24,21,45,58
92,Tanner,Pearson,69,21,24,45,27
93,Andre,Burakovsky,58,20,25,45,22
94,Alex,DeBrincat,70,18,27,45,15
95,Mikael,Backlund,70,16,29,45,26
96,Brock,Boeser,57,16,29,45,14
97,Brent,Burns,70,12,33,45,34
98,Nick,Schmaltz,70,11,34,45,20
99,Neal,Pionk,71,6,39,45,32
100,Keith,Yandle,69,5,40,45,20
101,Tyler,Toffoli,68,24,20,44,20
102,Brady,Tkachuk,71,21,23,44,106
103,Gabriel,Landeskog,54,21,23,44,47
104,Tom,Wilson,68,21,23,44,93
105,Clayton,Keller,70,17,27,44,28
106,Max,Domi,71,17,27,44,35
107,Anthony,Cirelli,68,16,28,44,30
108,Kris,Letang,61,15,29,44,38
109,Nikita,Gusev,66,13,31,44,12
110,Adam,Henrique,71,26,17,43,22
111,Brendan,Gallagher,59,22,21,43,29
112,Anders,Lee,68,20,23,43,47
113,Jake,Guentzel,39,20,23,43,14
114,Alex,Iafallo,70,17,26,43,14
115,Connor,Brown,71,16,27,43,24
116,Josh,Bailey,68,14,29,43,10
117,David,Krejci,61,13,30,43,23
118,Jean-Gabriel,Pageau,67,26,16,42,49
119,Victor,Olofsson,54,20,22,42,6
120,Gustav,Nyquist,70,15,27,42,16
121,Rickard,Rakell,65,15,27,42,12
122,Ryan,Getzlaf,69,13,29,42,58
123,Matt,Duchene,66,13,29,42,24
124,Robert,Thomas,66,10,32,42,18
125,Adam,Fox,70,8,34,42,32
126,Kevin,Hayes,69,23,18,41,34
127,Zach,Werenski,63,20,21,41,10
128,Jason,Zucker,60,20,21,41,21
129,Mikko,Rantanen,42,19,22,41,14
130,Ondrej,Palat,69,17,24,41,22
131,Nick,Suzuki,71,13,28,41,6
132,Aaron,Ekblad,67,5,36,41,26
133,Anthony,Duclair,66,23,17,40,18
134,James,van Riemsdyk,66,19,21,40,8
135,Jordan,Eberle,58,16,24,40,12
136,Dougie,Hamilton,47,14,26,40,32
137,Jeff,Petry,71,11,29,40,26
138,Erik,Karlsson,56,6,34,40,16
139,Rasmus,Dahlin,59,4,36,40,38
140,Conor,Garland,68,22,17,39,20
141,Jakob,Silfverberg,66,21,18,39,14
142,Jamie,Benn,69,19,20,39,53
143,Anthony,Beauvillier,68,18,21,39,15
144,Logan,Couture,52,16,23,39,18
145,Lars,Eller,69,16,23,39,48
146,Thomas,Chabot,71,6,33,39,42
147,Tyson,Barrie,70,5,34,39,16
148,Christian,Dvorak,70,18,20,38,12
149,Paul,Stastny,71,17,21,38,24
150,Anthony,Mantha,43,16,22,38,34
151,Phil,Kessel,70,14,24,38,22
152,Dylan,Strome,58,12,26,38,16
153,Vincent,Trocheck,62,11,27,38,49
154,Ryan,Ellis,49,8,30,38,19
155,Zach,Hyman,51,21,16,37,23
156,Tyler,Ennis,70,16,21,37,20
157,Charlie,Coyle,70,16,21,37,21
158,Mats,Zuccarello,65,15,22,37,18
159,Chris,Tierney,71,11,26,37,20
160,Oliver,Bjorkstrand,49,21,15,36,12
161,Nazem,Kadri,51,19,17,36,97
162,Jake,Virtanen,69,18,18,36,41
163,Tomas,Hertl,48,16,20,36,16
164,Martin,Necas,64,16,20,36,20
165,Shea,Weber,65,15,21,36,33
166,Ryan,Johansen,68,14,22,36,45
167,Nico,Hischier,58,14,22,36,12
168,Kasperi,Kapanen,69,13,23,36,22
169,Ivan,Provorov,69,13,23,36,24
170,Jaccob,Slavin,68,6,30,36,10
171,Jake,DeBrusk,65,19,16,35,14
172,Nick,Bonino,67,18,17,35,16
173,Dustin,Brown,66,17,18,35,22
174,Carl,Soderberg,70,17,18,35,18
175,Jared,McCann,66,14,21,35,17
176,Ryan,Pulock,68,10,25,35,14
177,Miro,Heiskanen,68,8,27,35,12
178,Drew,Doughty,67,7,28,35,36
179,Frank,Vatrano,69,16,18,34,30
180,Alexander,Radulov,60,15,19,34,46
181,Zack,Kassian,59,15,19,34,69
182,Calle,Jarnkrok,64,15,19,34,14
183,Mikhail,Sergachev,70,10,24,34,58
184,Kevin,Shattenkirk,70,8,26,34,38
185,Oscar,Klefbom,62,5,29,34,24
186,Samuel,Girard,70,4,30,34,17
187,Brandon,Saad,58,21,12,33,16
188,Roope,Hintz,60,19,14,33,16
189,Brett,Connolly,69,19,14,33,26
190,Joonas,Donskoi,65,16,17,33,26
191,Kevin,Labanc,70,14,19,33,38
192,Adam,Gaudette,59,12,21,33,37
193,Matt,Niskanen,68,8,25,33,29
194,Mattias,Ekholm,68,8,25,33,32
195,Rasmus,Ristolainen,69,6,27,33,46
196,Alexander,Edler,59,5,28,33,62
197,Darnell,Nurse,71,5,28,33,48
198,Blake,Coleman,66,21,11,32,56
199,Patric,Hornqvist,52,17,15,32,36
200,Andrew,Mangiapane,68,17,15,32,18
201,Jesper,Bratt,60,16,16,32,6
202,Robby,Fabbri,61,15,17,32,20
203,Jared,Spurgeon,62,12,20,32,18
204,Adrian,Kempe,69,11,21,32,29
205,Derick,Brassard,66,10,22,32,16
206,Pavel,Zacha,65,8,24,32,14
207,John,Klingberg,58,6,26,32,22
208,Charlie,McAvoy,67,5,27,32,41
209,Alex,Goligoski,70,4,28,32,24
210,James,Neal,55,19,12,31,12
211,Craig,Smith,69,18,13,31,34
212,Vladislav,Namestnikov,65,17,14,31,45
213,Luke,Kunin,63,15,16,31,55
214,Joe,Pavelski,67,14,17,31,29
215,Tyler,Johnson,65,14,17,31,16
216,Dominik,Kahun,56,12,19,31,8
217,J.T.,Compher,67,11,20,31,18
218,Nick,Foligno,67,10,21,31,62
219,Rocco,Grimaldi,66,10,21,31,10
220,Filip,Hronek,65,9,22,31,46
221,Kyle,Turris,62,9,22,31,22
222,Damon,Severson,69,8,23,31,52
223,Joe,Thornton,70,7,24,31,34
224,Nate,Schmidt,59,7,24,31,12
225,Mark,Giordano,60,5,26,31,34
226,Josh,Morrissey,65,5,26,31,24
227,Mikael,Granlund,63,17,13,30,28
228,Joel,Armia,58,16,14,30,28
229,Zach,Sanford,58,16,14,30,28
230,Warren,Foegele,68,13,17,30,34
231,Yanni,Gourde,70,10,20,30,49
232,Oliver,Ekman-Larsson,66,9,21,30,38
233,Marcus,Johansson,60,9,21,30,20
234,Seth,Jones,56,6,24,30,20
235,Denis,Gurianov,64,20,9,29,13
236,Tyler,Bozak,67,13,16,29,10
237,Jesper,Fast,69,12,17,29,20
238,Jack,Roslovic,71,12,17,29,12
239,Nino,Niederreiter,67,11,18,29,42
240,Derek,Ryan,68,10,19,29,10
241,Cam,Fowler,59,9,20,29,20
242,Ryan,Dzingel,64,8,21,29,30
243,Joel,Eriksson Ek,62,8,21,29,22
244,Erik,Gustafsson,66,6,23,29,27
245,Viktor,Arvidsson,57,15,13,28,26
246,Derek,Stepan,70,10,18,28,16
247,Colton,Parayko,64,10,18,28,16
248,Alexander,Kerfoot,65,9,19,28,32
249,Jordan,Greenway,67,8,20,28,54
250,Devon,Toews,68,6,22,28,16
251,Jonas,Brodin,69,2,26,28,24
252,Noel,Acciari,66,20,7,27,21
253,Jeff,Carter,60,17,10,27,36
254,Scott,Laughton,49,13,14,27,26
255,Valeri,Nichushkin,65,13,14,27,14
256,Artturi,Lehkonen,70,13,14,27,24
257,Jordan,Staal,68,8,19,27,40
258,Jacob,Trouba,70,7,20,27,61
259,Dmitry,Orlov,69,4,23,27,36
260,Duncan,Keith,61,3,24,27,18
261,Morgan,Rielly,47,3,24,27,24
262,Cam,Atkinson,44,12,14,26,6
263,Jakob,Chychrun,63,12,14,26,38
264,Chandler,Stephenson,65,11,15,26,16
265,Andreas,Athanasiou,55,11,15,26,30
266,Ivan,Barbashev,69,11,15,26,23
267,Kailer,Yamamoto,27,11,15,26,12
268,Ilya,Kovalchuk,46,10,16,26,18
269,Andrew,Copp,63,10,16,26,10
270,Danton,Heinen,67,10,16,26,10
271,Alex,Nylander,65,10,16,26,10
272,Ryan,Graves,69,9,17,26,45
273,Barclay,Goodrow,70,8,18,26,97
274,John,Marino,56,6,20,26,20
275,Ian,Cole,65,4,22,26,36
276,Lawson,Crouse,66,15,10,25,33
277,Derek,Grant,56,15,10,25,30
278,Matt,Calvert,50,12,13,25,39
279,Lucas,Wallmark,67,12,13,25,18
280,Marcus,Foligno,59,11,14,25,30
281,Brandon,Tanev,68,11,14,25,16
282,Nick,Cousins,65,10,15,25,35
283,Jason,Spezza,58,9,16,25,18
284,Travis,Zajac,69,9,16,25,28
285,Wayne,Simmonds,68,8,17,25,66
286,Carl,Hagelin,58,8,17,25,16
287,Travis,Sanheim,69,8,17,25,32
288,Erik,Haula,48,12,12,24,22
289,Boone,Jenner,70,11,13,24,36
290,Alex,Chiasson,65,11,13,24,42
291,Alex,Galchenyuk,59,8,16,24,16
292,Brady,Skjei,67,8,16,24,45
293,Ondrej,Kase,55,7,17,24,14
294,Matt,Dumba,69,6,18,24,41
295,Sean,Walker,70,5,19,24,26
296,Jake,Gardiner,68,4,20,24,30
297,Filip,Chytil,60,14,9,23,10
298,Jeff,Skinner,59,14,9,23,18
299,Ryan,Donato,62,14,9,23,12
300,Oskar,Sundqvist,57,12,11,23,28
301,Miles,Wood,68,11,12,23,57
302,Kaapo,Kakko,66,10,13,23,14
303,Conor,Sheary,63,10,13,23,10
304,Vince,Dunn,71,9,14,23,27
305,Patrick,Maroon,64,9,14,23,71
306,Tyson,Jost,67,8,15,23,22
307,Ilya,Mikheyev,39,8,15,23,4
308,Kirby,Dach,64,8,15,23,24
309,Colin,White,61,7,16,23,39
310,Sonny,Milano,55,7,16,23,26
311,Blake,Lizotte,65,6,17,23,20
312,Jake,Muzzin,53,6,17,23,40
313,Sean,Kuraly,69,6,17,23,34
314,Sami,Vatanen,47,5,18,23,22
315,Esa,Lindell,69,3,20,23,12
316,Hampus,Lindholm,56,2,21,23,34
317,Patrick,Marleau,66,11,11,22,14
318,Richard,Panik,59,9,13,22,36
319,Teddy,Blueger,69,9,13,22,25
320,Pierre-Edouard,Bellemare,69,9,13,22,17
321,Dominik,Simon,64,7,15,22,12
322,Sam,Steel,65,6,16,22,20
323,Alexander,Wennberg,57,5,17,22,16
324,Vinnie,Hinostroza,68,5,17,22,14
325,Noah,Hanifin,70,5,17,22,12
326,Rasmus,Andersson,70,5,17,22,57
327,Marcus,Pettersson,69,2,20,22,35
328,Josh,Archibald,62,12,9,21,12
329,Ben,Chiarot,69,9,12,21,61
330,Jason,Dickinson,65,9,12,21,6
331,Nick,Ritchie,48,9,12,21,97
332,Joel,Farabee,52,8,13,21,39
333,Matt,Nieto,70,8,13,21,6
334,Andreas,Johnsson,43,8,13,21,14
335,Jack,Hughes,61,7,14,21,10
336,Valtteri,Filppula,70,6,15,21,24
337,Tyler,Myers,68,6,15,21,49
338,Mattias,Janmark,62,6,15,21,12
339,Ethan,Bear,71,5,16,21,33
340,Corey,Perry,57,5,16,21,70
341,Mikko,Koivu,55,4,17,21,28
342,Will,Butcher,56,4,17,21,6
343,Matt,Grzelcyk,68,4,17,21,34
344,Nick,Leddy,60,3,18,21,14
345,Artem,Anisimov,49,15,5,20,8
346,Radek,Faksa,66,11,9,20,42
347,Emil,Bemstrom,56,10,10,20,8
348,Ryan,Hartman,69,9,11,20,69
349,Nick,Paul,56,9,11,20,24
350,Jimmy,Vesey,64,9,11,20,15
351,Milan,Lucic,68,8,12,20,54
352,Tyler,Pitlick,63,8,12,20,12
353,Michael,Matheson,59,8,12,20,14
354,Michael,Raffl,58,8,12,20,14
355,Joel,Edmundson,68,7,13,20,72
356,Chris,Tanev,69,2,18,20,41
357,Zemgus,Girgensons,69,12,7,19,10
358,Brett,Howden,70,9,10,19,28
359,Kyle,Okposo,52,9,10,19,28
360,Anders,Bjork,58,9,10,19,10
361,Brad,Hunt,59,8,11,19,6
362,Carter,Rowney,71,8,11,19,14
363,Josh,Leivo,36,7,12,19,4
364,William,Carrier,71,7,12,19,39
365,Anton,Stralman,69,5,14,19,14
366,Connor,Murphy,58,5,14,19,27
367,Brandon,Carlo,67,4,15,19,33
368,T.J.,Brodie,64,4,15,19,36
369,Justin,Braun,62,3,16,19,18
370,Oskar,Lindblom,30,11,7,18,4
371,Mark,Pysyk,58,9,9,18,20
372,P.K.,Subban,68,7,11,18,79
373,Mark,Borowiecki,53,7,11,18,58
374,Mackenzie,Weegar,45,7,11,18,33
375,Cedric,Paquette,61,7,11,18,42
376,Marcus,Sorensen,66,7,11,18,26
377,Johan,Larsson,62,6,12,18,26
378,Brendan,Lemieux,59,6,12,18,111
379,Brandon,Montour,54,5,13,18,28
380,Vladislav,Gavrikov,69,5,13,18,18
381,Brett,Pesce,61,4,14,18,27
382,Matt,Roy,70,4,14,18,10
383,Michal,Kempny,58,3,15,18,22
384,Justin,Holl,68,2,16,18,43
385,Brandon,Sutter,44,8,9,17,25
386,Alex,Tuch,42,8,9,17,8
387,Alex,Steen,55,7,10,17,12
388,Kyle,Clifford,69,7,10,17,68
389,Brock,McGinn,68,7,10,17,17
390,Troy,Stecher,69,5,12,17,32
391,Olli,Maatta,65,4,13,17,20
392,Madison,Bowey,53,3,14,17,34
393,Darren,Helm,68,9,7,16,37
394,Garnet,Hathaway,66,9,7,16,79
395,Blake,Comeau,55,8,8,16,36
396,David,Kampf,70,8,8,16,8
397,Colton,Sceviour,69,6,10,16,6
398,Michael,Amadio,68,6,10,16,10
399,Dillon,Dube,45,6,10,16,6
400,Justin,Faulk,69,5,11,16,32
401,Tucker,Poolman,57,4,12,16,24
402,Ben,Hutton,65,4,12,16,14
403,Philippe,Myers,50,4,12,16,30
404,Erik,Johnson,59,3,13,16,20
405,Alec,Martinez,51,3,13,16,23
406,Mike,Reilly,44,1,15,16,24
407,Colton,Sissons,57,9,6,15,20
408,Drake,Caggiula,40,9,6,15,32
409,Filip,Zadina,28,8,7,15,2
410,Ryan,Reaves,71,8,7,15,47
411,Jordan,Weal,49,8,7,15,14
412,Riley,Sheahan,66,8,7,15,6
413,Tomas,Nosek,67,8,7,15,20
414,Pierre,Engvall,48,8,7,15,6
415,Mathieu,Perreault,49,7,8,15,10
416,Nic,Dowd,56,7,8,15,28
417,Jonathan,Drouin,27,7,8,15,14
418,Nicolas,Aube-Kubel,36,7,8,15,19
419,Brian,Boyle,39,6,9,15,17
420,Marc-Edouard,Vlasic,70,5,10,15,10
421,Cody,Eakin,49,5,10,15,16
422,Troy,Terry,47,4,11,15,6
423,Henri,Jokiharju,69,4,11,15,32
424,Nate,Thompson,70,4,11,15,30
425,Ryan,Carpenter,69,3,12,15,28
426,Michael,Del Zotto,49,2,13,15,14
427,Radko,Gudas,63,2,13,15,40
428,Casey,Cizikas,48,10,4,14,41
429,Carson,Soucy,55,7,7,14,18
430,Michael,Frolik,57,6,8,14,28
431,Nick,Holden,61,6,8,14,13
432,Austin,Watson,53,6,8,14,65
433,Zdeno,Chara,68,5,9,14,60
434,Riley,Nash,64,5,9,14,10
435,Leo,Komarov,48,4,10,14,10
436,Nikolai,Prokhorkin,43,4,10,14,6
437,Haydn,Fleury,45,4,10,14,8
438,Andrew,Cogliano,68,3,11,14,30
439,Andy,Greene,63,2,12,14,16
440,Brenden,Dillon,69,1,13,14,104
441,Ryan,Lindgren,60,1,13,14,47
442,Carter,Verhaeghe,52,9,4,13,8
443,Nicolas,Deslauriers,59,7,6,13,92
444,Antoine,Roussel,41,7,6,13,43
445,Zach,Aston-Reese,57,6,7,13,28
446,Alexandre,Texier,36,6,7,13,10
447,Loui,Eriksson,49,6,7,13,12
448,Sam,Gagner,42,6,7,13,12
449,Sammy,Blais,40,6,7,13,20
450,Sam,Lafferty,50,6,7,13,23
451,Scott,Mayfield,67,5,8,13,53
452,Victor,Rask,43,5,8,13,6
453,Adam,Boqvist,41,4,9,13,6
454,Marco,Scandella,62,4,9,13,20
455,Nikita,Zadorov,64,4,9,13,65
456,Jake,McCabe,66,3,10,13,41
457,Robert,Hagg,49,3,10,13,30
458,Jordan,Oesterle,58,3,10,13,14
459,Jordan,Martinook,45,2,11,13,22
460,Sam,Bennett,52,8,4,12,36
461,Max,Jones,59,8,4,12,36
462,Frederik,Gauthier,61,7,5,12,10
463,Eric,Robinson,50,7,5,12,12
464,Trevor,Lewis,56,6,6,12,16
465,Melker,Karlsson,61,6,6,12,20
466,Shayne,Gostisbehere,42,5,7,12,20
467,Devin,Shore,45,5,7,12,8
468,Erik,Cernak,67,5,7,12,59
469,Cody,Glass,39,5,7,12,6
470,Denis,Malgin,44,4,8,12,14
471,Travis,Hamonic,50,3,9,12,27
472,Justin,Schultz,46,3,9,12,6
473,Ron,Hainsey,64,1,11,12,12
474,Ryan,McDonagh,50,1,11,12,19
475,Nikita,Zaitsev,58,1,11,12,22
476,Justin,Williams,20,8,3,11,6
477,Michael,Grabner,46,8,3,11,6
478,Austin,Wagner,65,6,5,11,39
479,Brad,Richardson,59,6,5,11,20
480,Dylan,Gambrell,50,5,6,11,17
481,Dante,Fabbro,64,5,6,11,38
482,Max,Comtois,29,5,6,11,24
483,Travis,Dermott,56,4,7,11,37
484,Dominic,Toninato,46,4,7,11,37
485,Victor,Mete,51,4,7,11,20
486,Zack,Smith,50,4,7,11,29
487,Mike,Green,50,3,8,11,32
488,Jack,Johnson,67,3,8,11,26
489,Brendan,Leipsic,61,3,8,11,13
490,Jacob,Larsson,60,2,9,11,12
491,Mario,Ferraro,61,2,9,11,30
492,Johnny,Boychuk,64,2,9,11,14
493,Marc,Staal,52,2,9,11,16
494,Nicolas,Hague,38,1,10,11,32
495,Colin,Miller,51,1,10,11,22
496,Jason,Demers,50,0,11,11,25
497,David,Savard,68,0,11,11,35
498,Mackenzie,MacEachern,51,7,3,10,33
499,Chris,Wagner,67,6,4,10,47
500,Jujhar,Khaira,64,6,4,10,38
501,Trevor,Moore,42,6,4,10,6
502,Evan,Rodrigues,45,6,4,10,14
503,Kevin,Stenlund,32,6,4,10,8
504,Curtis,Lazar,38,5,5,10,9
505,Nicolas,Roy,28,5,5,10,8
506,Gaetan,Haas,58,5,5,10,6
507,Nathan,Gerbe,30,4,6,10,22
508,Paul,Byron,29,4,6,10,4
509,Adam,Lowry,49,4,6,10,23
510,Tobias,Rieder,55,4,6,10,6
511,Michael,Dal Colle,53,4,6,10,12
512,Vladimir,Tarasenko,10,3,7,10,0
513,Jamie,Oleksiak,69,3,7,10,41
514,Andrew,Shaw,26,3,7,10,33
515,Travis,Boyd,24,3,7,10,2
516,Jayce,Hawryluk,26,3,7,10,16
517,Colin,Blackwell,27,3,7,10,10
518,Drake,Batherson,23,3,7,10,13
519,Luca,Sbisa,44,2,8,10,37
520,Dmitry,Kulikov,51,2,8,10,32
521,Slater,Koekkoek,42,1,9,10,42
522,Dylan,DeMelo,59,0,10,10,37
523,Stefan,Noesen,40,7,2,9,32
524,Christian,Fischer,56,6,3,9,16
525,Luke,Glendening,60,6,3,9,14
526,Greg,McKegg,53,5,4,9,17
527,Dmytro,Timashov,44,4,5,9,16
528,Caleb,Jones,43,4,5,9,10
529,Jordan,Kyrou,28,4,5,9,8
530,Casey,Mittelstadt,31,4,5,9,2
531,Frans,Nielsen,60,4,5,9,8
532,Erik,Gudbranson,51,4,5,9,95
533,Kevin,Rooney,49,4,5,9,20
534,Markus,Nutivaara,37,3,6,9,4
535,Joakim,Nygard,33,3,6,9,8
536,Jonas,Siegenthaler,64,2,7,9,43
537,Radim,Simek,48,2,7,9,14
538,Brayden,McNabb,71,2,7,9,40
539,Taylor,Fedun,27,2,7,9,8
540,Ryan,Murray,27,2,7,9,4
541,Jacob,De La Rose,50,2,7,9,10
542,Jay,Bouwmeester,56,1,8,9,20
543,Patrik,Nemeth,64,1,8,9,28
544,Josh,Manson,50,1,8,9,37
545,Adam,Pelech,38,1,8,9,20
546,Kris,Russell,55,0,9,9,14
547,Martin,Frk,17,6,2,8,4
548,Jesperi,Kotkaniemi,36,6,2,8,23
549,Bobby,Ryan,24,5,3,8,22
550,Matt,Martin,55,5,3,8,40
551,Mason,Appleton,46,5,3,8,20
552,Tyler,Motte,34,4,4,8,10
553,Brendan,Guhle,30,4,4,8,10
554,Brendan,Smith,62,3,5,8,71
555,Kurtis,MacDermid,45,3,5,8,47
556,Josh,Brown,56,3,5,8,39
557,Andrej,Sekera,57,2,6,8,14
558,Jay,Beagle,55,2,6,8,38
559,Dennis,Cholowski,36,2,6,8,6
560,Brian,Dumoulin,28,1,7,8,10
561,Nathan,Beaulieu,38,1,7,8,29
562,Scott,Harrington,39,1,7,8,16
563,Cody,Ceci,56,1,7,8,20
564,Trevor,van Riemsdyk,49,1,7,8,10
565,Matthew,Benning,43,1,7,8,15
566,Vladislav,Kamenev,38,1,7,8,8
567,Logan,Brown,23,1,7,8,4
568,Rasmus,Sandin,28,1,7,8,10
569,Dan,Hamhuis,60,0,8,8,35
570,Nick,Jensen,68,0,8,8,13
571,Anthony,Bitetto,51,0,8,8,32
572,Mark,Jankowski,56,5,2,7,14
573,Mathieu,Joseph,37,4,3,7,16
574,Joakim,Nordstrom,48,4,3,7,17
575,Gabriel,Vilardi,10,3,4,7,4
576,Joel,Kellman,31,3,4,7,4
577,Cal,Clutterbuck,37,3,4,7,22
578,Jansen,Harkins,29,2,5,7,5
579,Oliver,Kylington,48,2,5,7,16
580,Morgan,Frost,20,2,5,7,4
581,Taro,Hirose,26,2,5,7,6
582,Carl,Gunnarsson,36,2,5,7,16
583,Michael,Stone,33,2,5,7,16
584,Mirco,Mueller,50,2,5,7,23
585,Jon,Merrill,49,2,5,7,32
586,Jan,Rutta,33,1,6,7,14
587,Antti,Suomela,20,1,6,7,4
588,Noah,Dobson,34,1,6,7,8
589,Juuso,Riikola,36,1,6,7,6
590,Zach,Bogosian,27,1,6,7,22
591,Jordie,Benn,44,1,6,7,17
592,Trevor,Daley,43,0,7,7,20
593,Brett,Kulak,56,0,7,7,12
594,Tim,Schaller,53,5,1,6,14
595,Zack,MacEwen,17,5,1,6,20
596,Joey,Anderson,18,4,2,6,2
597,Tom,Kuhnhackl,28,3,3,6,2
598,Nick,Shore,63,3,3,6,20
599,Justin,Dowling,29,3,3,6,8
600,Mitchell,Stephens,38,3,3,6,10
601,Filip,Chlapik,31,3,3,6,10
602,Par,Lindholm,40,3,3,6,4
603,Robert,Bortuzzo,42,2,4,6,21
604,Gabriel,Bourque,52,2,4,6,7
605,Brett,Ritchie,27,2,4,6,21
606,Chad,Ruhwedel,41,2,4,6,12
607,Scott,Sabourin,35,2,4,6,33
608,Matthew,Highmore,36,2,4,6,6
609,Yakov,Trenin,21,2,4,6,9
610,Deryk,Engelland,49,1,5,6,37
611,David,Backes,22,1,5,6,22
612,Calvin,de Haan,29,1,5,6,10
613,Adam,Larsson,49,1,5,6,35
614,Connor,Carrick,29,1,5,6,17
615,Karson,Kuhlman,25,1,5,6,13
616,Oscar,Fantenberg,36,1,5,6,6
617,Noah,Gregor,28,3,2,5,8
618,Zac,Rinaldo,19,3,2,5,34
619,Logan,Shaw,35,3,2,5,0
620,Jakob,Lilja,37,2,3,5,2
621,Bryan,Little,7,2,3,5,2
622,Stephen,Johns,17,2,3,5,10
623,Adam,Erne,56,2,3,5,28
624,Joseph,Blandisi,21,2,3,5,10
625,Matt,Luff,18,1,4,5,2
626,Ville,Heinola,8,1,4,5,4
627,Niklas,Hjalmarsson,27,1,4,5,14
628,Dale,Weise,23,1,4,5,16
629,Jarred,Tinordi,28,1,4,5,34
630,Micheal,Ferland,14,1,4,5,7
631,Tim,Heed,38,1,4,5,2
632,Joakim,Ryan,35,1,4,5,10
633,Dean,Kukan,33,1,4,5,12
634,Sami,Niku,17,0,5,5,12
635,Riley,Stillman,34,0,5,5,14
636,Libor,Hajek,28,0,5,5,12
637,Patrick,Russell,45,0,5,5,12
638,Jesper,Boqvist,35,4,0,4,8
639,Brent,Seabrook,32,3,1,4,8
640,Markus,Granlund,34,3,1,4,14
641,John,Hayden,43,3,1,4,77
642,Ross,Johnston,32,3,1,4,78
643,Morgan,Geekie,2,3,1,4,2
644,Mikkel,Boedker,20,2,2,4,0
645,Christoffer,Ehn,54,2,2,4,2
646,Aleksi,Saarela,9,2,2,4,0
647,Braydon,Coburn,40,1,3,4,16
648,Cameron,Gaunce,3,1,3,4,4
649,Martin,Marincin,26,1,3,4,14
650,Korbinian,Holzer,49,1,3,4,37
651,Valentin,Zykov,15,1,3,4,6
652,Dakota,Mermis,10,1,3,4,4
653,Josh,Anderson,26,1,3,4,17
654,Phil,Di Giuseppe,20,1,3,4,2
655,Brendan,Perlini,40,1,3,4,10
656,Josh,Mahura,11,1,3,4,2
657,Barrett,Hayton,20,1,3,4,14
658,Roman,Polak,41,0,4,4,24
659,Colin,Wilson,9,0,4,4,0
660,Danny,DeKeyser,8,0,4,4,4
661,Dryden,Hunt,21,0,4,4,24
662,Erik,Brannstrom,31,0,4,4,16
663,Carl,Grundstrom,13,0,4,4,8
664,Ilya,Lyubushkin,51,0,4,4,18
665,Isac,Lundestrom,15,0,4,4,0
666,Alex,True,12,0,4,4,2
667,Kieffer,Bellows,8,2,1,3,2
668,Givani,Smith,21,2,1,3,9
669,Martin,Kaut,9,2,1,3,2
670,Jake,Evans,13,2,1,3,0
671,John,Moore,24,2,1,3,11
672,Stefan,Matteau,9,2,1,3,5
673,Austin,Czarnik,8,2,1,3,0
674,Dennis,Gilbert,21,1,2,3,38
675,Mikhail,Vorobyev,20,1,2,3,6
676,Rudolfs,Balcers,15,1,2,3,0
677,Rasmus,Asplund,29,1,2,3,6
678,Andrew,Peeke,22,1,2,3,4
679,Vladimir,Sobotka,16,1,2,3,4
680,Yannick,Weber,41,1,2,3,14
681,Luke,Schenn,25,1,2,3,23
682,Andrew,Agozzino,22,1,2,3,4
683,Luke,Witkowski,12,1,2,3,13
684,Christian,Djoos,11,1,2,3,0
685,Dylan,Sikura,9,1,2,3,0
686,Christian,Jaros,13,0,3,3,6
687,Julien,Gauthier,17,0,3,3,8
688,Calle,Rosen,12,0,3,3,4
689,Adam,Brooks,7,0,3,3,0
690,Justin,Abdelkader,49,0,3,3,25
691,Greg,Pateryn,20,0,3,3,6
692,Alex,Biega,49,0,3,3,24
693,Matt,Irwin,36,0,3,3,15
694,Matt,Tennyson,20,0,3,3,6
695,Nic,Petan,16,0,3,3,4
696,Andreas,Englund,24,0,3,3,12
697,Tyler,Graovac,8,2,0,2,2
698,Connor,Clifton,31,2,0,2,12
699,Logan,O'Connor,16,2,0,2,2
700,Gerald,Mayhew,13,2,0,2,2
701,Cody,Goloubef,26,1,1,2,8
702,Sam,Carrick,9,1,1,2,0
703,Nick,Bjugstad,13,1,1,2,8
704,Fredrik,Claesson,5,1,1,2,0
705,Scott,Wilson,6,1,1,2,2
706,Christian,Folin,16,1,1,2,13
707,Charles,Hudon,15,1,1,2,0
708,Nathan,Walker,5,1,1,2,4
709,Nick,Merkley,4,1,1,2,2
710,Daniel,Sprong,8,1,1,2,0
711,Jeremy,Lauzon,19,1,1,2,29
712,Cole,Bardreau,10,1,1,2,6
713,Connor,Bunnaman,21,1,1,2,2
714,Ryan,Poehling,27,1,1,2,4
715,Nick,Caamano,12,1,1,2,4
716,Adam,Johnson,7,1,1,2,2
717,Steven,Kampfer,10,0,2,2,2
718,Mark,Barberio,21,0,2,2,16
719,Brandon,Pirri,16,0,2,2,8
720,Sven,Baertschi,6,0,2,2,4
721,Tomas,Jurco,12,0,2,2,4
722,Xavier,Ouellet,12,0,2,2,4
723,Matthew,Peca,14,0,2,2,0
724,Joel,Hanley,8,0,2,2,6
725,Jacob,Middleton,10,0,2,2,9
726,Joe,Hicketts,6,0,2,2,2
727,Zach,Senyshyn,4,0,2,2,0
728,Michael,McLeod,12,0,2,2,4
729,Nico,Sturm,6,0,2,2,0
730,Joel,Persson,13,0,2,2,2
731,Kyle,Capobianco,9,1,0,1,2
732,Lukas,Vejdemo,7,1,0,1,0
733,Vitaly,Abramov,2,1,0,1,2
734,Carsen,Twarynski,15,1,0,1,4
735,Klim,Kostin,4,1,0,1,0
736,David,Gustafsson,22,1,0,1,0
737,Egor,Korshkov,1,1,0,1,0
738,Cale,Fleury,41,1,0,1,6
739,David,Kase,6,1,0,1,0
740,Joel,Kiviranta,11,1,0,1,4
741,Mikey,Anderson,6,1,0,1,0
742,Andrew,Ladd,4,1,0,1,4
743,Troy,Brouwer,13,1,0,1,7
744,Micheal,Haley,22,1,0,1,50
745,Brandon,Manning,9,1,0,1,17
746,Patrick,Brown,1,1,0,1,0
747,Miikka,Salomaki,5,1,0,1,4
748,Alan,Quine,9,1,0,1,4
749,Jani,Hakanpaa,5,1,0,1,2
750,Daniel,Carr,11,1,0,1,4
751,Buddy,Robinson,5,1,0,1,7
752,Gemel,Smith,3,1,0,1,4
753,Colby,Cave,11,1,0,1,4
754,Maxim,Letunov,3,1,0,1,0
755,Anthony,Angello,8,1,0,1,4
756,Joel,L'Esperance,3,1,0,1,2
757,Niko,Mikkola,5,0,1,1,0
758,Anton,Lindholm,4,0,1,1,0
759,J.C.,Beaudin,22,0,1,1,7
760,Jordan,Gross,2,0,1,1,0
761,Tyler,Benson,7,0,1,1,0
762,Tim,Gettinger,2,0,1,1,0
763,Gage,Quinney,3,0,1,1,0
764,Mathieu,Olivier,8,0,1,1,4
765,Lias,Andersson,17,0,1,1,4
766,Timothy,Liljegren,11,0,1,1,2
767,Gustav,Lindstrom,16,0,1,1,14
768,Jason,Robertson,3,0,1,1,0
769,Eetu,Luostarinen,8,0,1,1,0
770,Alexander,Volkov,9,0,1,1,6
771,Jack,Studnicka,2,0,1,1,2
772,Lucas,Carlsson,6,0,1,1,0
773,Mason,Marchment,4,0,1,1,0
774,Zach,Whitecloud,16,0,1,1,4
775,Liam,Foudy,2,0,1,1,0
776,Martin,Fehervary,6,0,1,1,6
777,Kiefer,Sherwood,10,0,1,1,6
778,Jonathan,Davidsson,6,0,1,1,0
779,Lean,Bergmann,12,0,1,1,4
780,Chris,Stewart,16,0,1,1,21
781,Brian,Lashoff,9,0,1,1,6
782,Aaron,Ness,24,0,1,1,0
783,Derek,Forbort,20,0,1,1,4
784,Ben,Street,3,0,1,1,0
785,Andy,Andreoff,14,0,1,1,2
786,T.J.,Tynan,16,0,1,1,2
787,Nick,Seeler,12,0,1,1,15
788,Cory,Conacher,4,0,1,1,4
789,Brendan,Gaunce,1,0,1,1,2
790,Jonny,Brodzinski,3,0,1,1,0
791,Carl,Dahlstrom,15,0,1,1,6
792,Peter,Cehlarik,3,0,1,1,2
793,Paul,LaDue,2,0,1,1,0
794,Pontus,Aberg,5,0,1,1,0
795,Ryan,MacInnis,10,0,1,1,0
796,Clark,Bishop,5,0,1,1,4
797,Mark,Friedman,6,0,1,1,2
